20
GGGGGGGWWWWWWWWWWWWWWWWWWWWWWW
GGGGGGWWGGGWWWWWWGGGGWWWWWWWWW
GGGGWWWGGGGWWWWGGGGGGGGWWWWWWW
GGGGWWWGGWWWWWGGGGGGGGGWWWWWWW
GGGGWWWWWWWWWWGGGGGGGGWWWWWWWW
GGGGWWWWWWWWWGGGGGGGGWWWWWWWWW
GGGGGGWWWWWGGGGGGGGGWWWWWWWWWW
GGGGGGGGGGGGGGGGGGGWWWWWWWWWWW
GGGGGGGGGGGGGGGGGGGWWWWWWWWWWW
GGGGGGGGGGGGGGGGGGGWWWWWWWWWWW
GGGGGGGGGGGGGGGGGGGGGGWWWWWWWW
GGGGGGWWWWWGGGGGGGGGGGGGWWWWWW
GGGGWWWWWWWWGGGGGGGGGGGGWWWWWW
GGWWWWWWWWWWWWGGGGGGGGGGWWWWWW
WWWWWWWWWWWWWWGGGGGGGGGGGGGGGG
WWWWWWWWWWWWWWWGGGGGGGGGGGGGGG
WWWWWWWWWWWWWWWGGGGGGGGGGGGGGG
WWWWWWWWWWWWWWWGGGGGGGGGGGGGGG
WWWWWWWWWWWWWWWGGGGGGGGGGGGGGG
WWWWWWWWWWWWWWWGGGGGGGGGGGGGGG
2
grass.png
water.png