20
000000000000000000000000000000
000000001110000001111000000000
000000010000000110000110000000
000000000000001000000000000000
000000000000000000000000000000
000000000000010000000000000000
000011000001100000000000000000
000000111110000000000000000000
000000000000000000000000000000
000000000000000000000000000000
000000000000000000011100000000
000000000000000000000011000000
000000000000000000000000000000
000000000000000000000000000000
000000000000000000000000111111
000000000000000000000000000000
000000000000000000000000000000
000000000000000000000000000000
000000000000000000000000000000
000000000000000000000000000000
1
border-top.png