20
MM00M0000000000000000000000000
MM0000000000000000000000000000
MM000000M000000000TTT000000000
MMM00000000000000TTTT000000000
MMM000000000000TC0TT0000000000
MMM00000000000T0R0000000000000
MMM00000000000T0R0000000000000
VMM0000000000000R0000000000000
RMMRRRRRRRRRRRRRR0000000000000
RRRRM00000000000R0000000000000
0000000000000000R0V00000000000
0000000000000000RRRRRRTT000000
0M000000000000000MM00RTT000000
0000000000000000MMMM0RTT000000
00000000000000TTMMMMTRTTTTTTTT
000000000000000TTMMTTRTTTTTTTT
000000000000000TTTTTTRRRRRRTTT
000000000000000TTTTTTTTTTTRTTT
000000000000000TTTTTTTTTTTRTTT
000000000000000TTTTTTTTTTTRTTT
5
mountain.png
tree.png
road.png
castle.png
village.png