20
GG00G0000000000000000000000000
GG0000000000000000000000000000
GG000000G000000000HHH000000000
GGG00000000000000HHHH000000000
GGG000000000000HI0HH0000000000
GGG00000000000H0J0000000000000
GGG00000000000H0J0000000000000
KGG0000000000000J0000000000000
JGGJJJJJJJJJJJJJJ0000000000000
JJJJG00000000000J0000000000000
0000000000000000J0K00000000000
0000000000000000JJJJJJHH000000
0G000000000000000GG00JHH000000
0000000000000000GGGG0JHH000000
00000000000000HHGGGGHJHHHHHHHH
000000000000000HHGGHHJHHHHHHHH
000000000000000HHHHHHJJJJJJHHH
000000000000000HHHHHHHHHHHJHHH
000000000000000HHHHHHHHHHHJHHH
000000000000000HHHHHHHHHHHJHHH
36
1.png
2.png
3.png
4.png
5.png
6.png
7.png
8.png
9.png
10.png
11.png
12.png
13.png
14.png
15.png
16.png
17.png
18.png
19.png
20.png
21.png
22.png
23.png
24.png
25.png
26.png
27.png
28.png
29.png
30.png
31.png
32.png
33.png
34.png
35.png
36.png